####################
#S   #       #     #
# ## # ##### # ### #
# #  #   #   #   # #
# ## ### # ##### # #
#      # #       # #
###### # ######### #
#    # # #         #
# ## # # # ####### #
#          #E      #
####################